***********
*        G*
* **** ** *
* **** ** *
* ***  ** *
* *** *** *
* *** *** *
* **  *** *
* **  *** *
*B o      *
***********